11111111111111111111
10001000C00100000001
1001P10000000C000001
100010C000C1000001E1
11111111111111111111