11111
10P01
10C01
111E1
11Z11
11111