11111111111111111111
10001000000100000001
1001P100000000000001
100000000001000001E1
11111111111111111111