11111111111111111111
10001000C001000N0001
1001P100N0000C000001
100000C000C1000001E1
11111111111111111111